###############################
#     #           #  S  #     #
#     #     #     #     #     #
#     #     #     #           #
#     #     #     #     #     #
#           #           #     #
####### #################### ##
#     #     #     #     #     #
#     #     #     #     #     #
#     #     #                 #
#     #     #     #     #     #
#     #     #     #     #     #
############### ###### #### ###
#     #     #     #     #     #
#           #     #     #     #
#     #     #     #     #     #
#     #           #     #     #
#     #     #     #     #     #
# ################# ####### ###
#     #     #     #     #     #
#     #     #     #     #     #
#     #     #     #     #     #
#     #     #     #     #     #
#  E  #     #     #           #
###############################