######################      ##   ################
##                             #               E#
#########################      #                #
#                      #### ## ##################
# #################### #### ##                 ##
# ############################################   
                                        #  # ### 
## ###########                 ##########    ### 
##           #                 ########## ###### 
##############                          # ###### 
                               ########## ###### 
 #############                 ##########        
 #           # ########### ###########    #######
 # #         # ########### ########### ##########
 # ###########         ###                  #####
 # ################### ########### ####     #####
 S #                   ########### ####     #####
######################             ##############
